 R  1920 1080 
  NO ./texture/redbrick.xpm
    SO ./texture/wood.xpm

WE ./texture/mossy.xpm


EA ./texture/greystone.xpm

 S ./texture/barre.xpm



  F 0,  255,  0  
C 1, 0 ,  255  

    1   1111111111111111111111111
        1000000000110000000000001
        1011000001110000000000001
        1001000000000000000000001
111111111011000001110000000000001
10000000001100000111111111111111111
11110111111111011120000010000000001
11110111111111011101010010001020001
11000000110101011100000010000020001
1000000000000001100000011600020001
100000000000000011010100P0S02000001
11000001110101011111011110100000201
11110111 1110101 101111010000000001 
11111111 1111111 111111111111111111

